***X***X***
XX*X*XXX*X*
*X*******X*
*XXXXXXXXX*
*X*****X***
*X*XXX*X*XX
*X***X***X*
*X*X*XXXXX*
***X***X***
*XXXXX*X*XX
*****X***X*