*XXXXXXXXXXX***X*********************XXX*****************XXXXXXXXXXXXXXXXXXXXX*****X*************************X*****X***********X*******X
*XXXXXXXXXXX*X*X*XXXXXXXXXXXXXXXXXXX*XXX*XXXXXXXXXXXXXXX*XXXXXXXXXXXXXXXXXXXXX*XXXXX*X*XXXXXXXXXXXXXXXXXXXXX*X*XXX*XXXXXXX*XXX*X*XXXXX*X
***XXXXXXX***X*X***XXXXXXXXXXXXXXX***XXX*XXXXXXXXXXXXX***XXXXXXXXXXXXXXXXXXXXX*******X*XXXXXXXXXXXXXXXXXXXXX***XXX*X***X***XXX***XXXXX*X
XX*XXXXXXX*XXX*XXX*XXXXXXXXXXXXXXX*XXXXX*XXXXXXXXXXXXX*XXXXXXXXXXXXXXXXXXXXXXXXXXXXXXX*XXXXXXXXXXXXXXXXXXXXXXXXXXX*X*X*X*XXXXXXXXXXXXX*X
XX*XXXXX***X***XXX*XXXXXXXXXXXXXXX***XXX***XXXXX***X***XXXXXXXXXXXXXXXXXXXXX***X*****X*XXXXXXXXXXXXXXXXXXXXXXXXXXX***X***XXXXXXXXXXXXX*X
XX*XXXXX*XXX*XXXXX*XXXXXXXXXXXXXXXXX*XXXXX*XXXXX*X*X*XXXXXXXXXXXXXXXXXXXXXXX*X*X*XXX*X*XXXXXXXXXXXXXXXXXXXXXXXXXXXXXXXXXXXXXXXXXXXXXXX*X
XX***XXX*XXX*******XXXXXXXXXXXXXXXXX***X***XXXXX*X*X***XXXXXXXXXXXXXXXXXXXXX*X***X***X*XXXXXXXXXXXXXXXXXXXXXXXXXXXXXXXXXXXXXXXXX***XXX*X
XXXX*XXX*XXXXXXXXXXXXXXXXXXXXXXXXXXXXX*X*XXXXXXX*X*XXX*XXXXXXXXXXXXXXXXXXXXX*XXXXX*XXX*XXXXXXXXXXXXXXXXXXXXXXXXXXXXXXXXXXXXXXXXX*X*XXX*X
XXXX*X***XXXXXXXXXXXXXXXXXXXXXXXXX*****X*XXXXXXX*X***X*XXXXXXXXXXXXXXXXX***X***X***X***XXXXXXXXXXXXXXXXXXXXXXXXXXXXXXXXXXXXXXXXX*X***X*X
XXXX*X*XXXXXXXXXXXXXXXXXXXXXXXXXXX*XXXXX*XXXXXXX*XXX*X*XXXXXXXXXXXXXXXXX*X*XXX*X*XXX*XXXXXXXXXXXXXXXXXXXXXXXXXXXXXXXXXXXXXXXXXXX*XXX*X*X
XX***X*XXXXXXXXXXXXXXXXXXXXXXXXXXX*******XXXXXXX***X*X*XXX*****XXX*******X***X*X*****XXXXXXXXXXXXXXXXXXXXXXXXXXXXXXXXXXXXXXXXXXX***X***X
XX*XXX*XXXXXXXXXXXXXXXXXXXXXXXXXXXXXXXXXXXXXXXXXXX*X*X*XXX*XXX*XXX*XXXXXXXXX*XXXXX*XXXXXXXXXXXXXXXXXXXXXXXXXXXXXXXXXXXXXXXXXXXXXXX*XXXXX
***X***XXXXXXXXXXXXXXXXXXXXXXXXXXXXXXXXXXXXXXX***X*X***XXX*XXX*XXX***X*****X*X*****XXXXXXXXXXXXXXXXXXXXXXXXXXXXXXXXXXXXXXXXXXXXX***X***X
*XXX*XXXXXXXXXXXXXXXXXXXXXXXXXXXXXXXXXXXXXXXXX*XXX*X*XXXXX*XXX*XXXXX*X*XXX*X*X*XXXXXXXXXXXXXXXXXXXXXXXXXXXXXXXXXXXXXXXXXXXXXXXXX*XXX*X*X
*****XXXXXXXXXXXXXXXXXXXXXXXXXXXXXXXXXXXXXXXXX*****X*XXX***XXX*****X*X***X***X***XXXXXXXXXXXXXXXXXXXXXXXXXXXXXXXXXXXXXXXXXXXXXXX***X*X*X
XXXXXXXXXXXXXXXXXXXXXXXXXXXXXXXXXXXXXXXXXXXXXXXXXXXX*XXX*XXXXXXXXX*X*XXXXXXX*XXX*XXXXXXXXXXXXXXXXXXXXXXXXXXXXXXXXXXXXXXXXXXXXXXXXX*X*X*X
XXXXXXXXXXXXXXXXXXXXXXXXXXXXXXXXXXXXXXXXXXXXXXXXXXXX*****XXXXXXXXX*X*X***X*******XXXXXXXXXXXXXXXXXXXXXXXXXXXXXXXXXXXXXXXXXXXXXXXXX***X*X
XXXXXXXXXXXXXXXXXXXXXXXXXXXXXXXXXXXXXXXXXXXXXXXXXXXXXXXXXXXXXXXXXX*XXX*X*X*XXXXXXXXXXXXXXXXXXXXXXXXXXXXXXXXXXXXXXXXXXXXXXXXXXXXXXXXXXX*X
XXXXXXXXXXXXXXXXXXXXXXXXXXXXXXXXXXXXXXXXXXXXXXXXXXXXXXXXXXXXXXXXXX*****X***XXXXXXXXXXXXXXXXXXXXXXXXXXXXXXXXXXXXXXXXXXXXXXXXXXXXXXXXX***X
XXXXXXXXXXXXXXXXXXXXXXXXXXXXXXXXXXXXXXXXXXXXXXXXXXXXXXXXXXXXXXXXXXXXXXXXXXXXXXXXXXXXXXXXXXXXXXXXXXXXXXXXXXXXXXXXXXXXXXXXXXXXXXXXXXXX*XX*
XXXXXXXXXXXXXXXXXXXXXXXXXXXXXXXXXXXXXXXXXXXXXXXXXXXXXXXXXXXXXXXXXXXXXXXXXXXXXXXXXXXXXXXXXXXXXXXXXXXXXXXXXXXXXXXXXXXXXXXXXXXXXXXXXXXX****