***************X*****X*******XXXXXXXXXXX
XXXXXXXXXXXXXX*X*XXX*X*XXXXX*XXXXXXXXXXX
XXXXXXXXXX*****X*X***X***X***XXXXXXXXXXX
XXXXXXXXXX*XXXXX*X*XXXXX*X*XXXXXXXXXXXXX
XXXXXXXXXX*X*****X*******X***XXXXXXXXXXX
XXXXXXXXXX*X*XXXXXXXXXXXXXXX*XXXXXXXXXXX
***********X***XXXXXXXXX*****XXXXXXXXXXX
*XXXXXXXXXXXXX*XXXXXXXXX*XXXXXXXXXXXXXXX
*X***X*********XXXXXXXXX*******XXX*****X
*X*X*X*XXXXXXXXXXXXXXXXXXXXXXX*XXX*XXX*X
***X***XXXXXXXXXXXXXXXXXXXXXXX*X***X***X
XXXXXXXXXXXXXXXXXXXXXXXXXXXXXX*X*XXX*XXX
XXXXXXXXXXXXXXXXXXXXXXXXXXXXXX***XXX***X
XXXXXXXXXXXXXXXXXXXXXXXXXXXXXXXXXXXXXX*X
XXXXXXXXXXXXXXXXXXXXXXXXXXXXXXXXXXXX***X
XXXXXXXXXXXXXXXXXXXXXXXXXXXXXXXXXXXX*XXX
XXXXXXXXXXXXXXXXXXXXXXXXXXXXXXXXXXXX***X
XXXXXXXXXXXXXXXXXXXXXXXXXXXXXXXXXXXXXX*X
XXXXXXXXXXXXXXXXXXXXXXXXXXXXXXXXXXXXXX*X
XXXXXXXXXXXXXXXXXXXXXXXXXXXXXXXXXXXXXX*X
XXXXXXXXXXXXXXXXXXXXXXXXXXXXXXXXXXXXXX*X
XXXXXXXXXXXXXXXXXXXXXXXXXXXXXXXXXXXXXX*X
XXXXXXXXXXXXXXXXXXXXXXXXXXXXXXXXXXXXXX*X
XXXXXXXXXXXXXXXXXXXXXXXXXXXXXXXXXXXXXX*X
XXXXXXXXXXXXXXXXXXXXXXXXXXXXXXXXXXXXXX*X
XXXXXXXXXXXXXXXXXXXXXXXXXXXXXXXXXXXXXX*X
XXXXXXXXXXXXXXXXXXXXXXXXXXXXXXXXXXXXXX*X
XXXXXXXXXXXXXXXXXXXXXXXXXXXXXXXXXXXXXX*X
XXXXXXXXXXXXXXXXXXXXXXXXXXXXXXXX*****X*X
XXXXXXXXXXXXXXXXXXXXXXXXXXXXXXXX*XXX*X*X
XXXXXXXXXXXXXXXXXXXXXXXX*******X***X*X*X
XXXXXXXXXXXXXXXXXXXXXXXX*XXXXX*XXX*X*X*X
XXXXXXXXXXXXXXXXXXXXXXXX*****X***X*X***X
XXXXXXXXXXXXXXXXXXXXXXXXXXXXXX*X*X*XXXXX
XXXXXXXXXXXXXXXXXXXXXXXXXXXX***X*X*****X
XXXXXXXXXXXXXXXXXXXXXXXXXXXX*XXX*XXXXX*X
XXXXXXXXXXXXXXXXXXXXXXXXXXXX*X***X*****X
XXXXXXXXXXXXXXXXXXXXXXXXXXXX*XXXXX*X*XXX
XXXXXXXXXXXXXXXXXXXXXXXXXXXX*******X****
XXXXXXXXXXXXXXXXXXXXXXXXXXXXXXXXXXXXXXX*