.#.....#...#.........#.......#.........#.#.....#.......
.#.###.#.#.###.#####.#.#####.###.#####.#.#.#.#.#.#####.
...#.#...#...#.#...#.#.#...#.#.......#.....#.#.#.#...#.
####.#######.#.#.#.###.#.#.#.#.###############.#.#.#.#.
.....#.....#.#...#...#.#.#.#...#.....#.....#...#.#.#...
.#.###.#####.#.#####.###.#.###.#.###.#.#.#.#.###.#.####
.#...#.#.....#.....#.....#.#...#.#.....#.#.#...#.#.####
.###.#.#.#########.#######.#.###.#######.#.###.#.#.####
.###.#.#...#.....#.#.#.....#.#.......#...#.###...#.....
.###.#.###.#.###.#.#.#.#####.#.#####.#.###.###########.
.###...###.#.#.#.....#...#...#.#.....#.#.#...........#.
.#########.#.#.#########.#.###.#.#####.#.#.###########.
.........#.#.#...#.....#...###.#.#...#...#.......#...#.
.#######.#.#.###.#.###.#######.#.#.#.#############.#.#.
.......#.#.#.#...#...#.....#...#.#.#...#...........#.#.
.#####.#.#.#.#.#####.#####.#.###.#.###.#.#############.
.......#.#.#.#.....#.....#...#.#...#...#.#.......#.....
.#########.#.#.###.#####.#####.#.###.###.#######.#.####
.........#...#.#.......#.....#...#.#.....#...#...#.....
.#######.#####.#######.#######.###.#.#####.#.#.#######.
.###...#.......#...#...#.#.....#...#.#...#.#.#.......#.
.###.#########.#.#.#.###.#.#.###.###.#.#.#.#.#######.#.
...#...#.......#.#.#.....#.#...#...#.#.#.#.#.......#.#.
##.###.#.#######.#.#######.###.###.#.#.###.#.#####.#.#.
.#.#...#.#.......#.#.....#...#...#...#.#...#...#.....#.
.#.#.###.#.#.#####.#####.#.#.###.#####.#.#######.#####.
...#.#...#.#.#.....#...#.#.#...#.......#.......#...###.
####.#.###.###.#.###.#.#.#.###.###############.###.###.
...#.#.#...#...#.#...#...#...#.............#...#...###.
.#.#.#.#.###.#####.###.#####.#############.#.###.#####.
.#.#.#.#...#.....#.#...#...#...###########.#...#.......
.#.#.#.#####.###.###.#.#.#.###.###########.###.########
.#...#.#.....#.#.....#...#...#.#######...#...#.....#...
####.#.#.#####.#####.#######.#.#######.#.###.#####.#.#.
...#.#.#.....#.....#.......#...###...#.#.....#.....#.#.
.#.#.#.#####.#####.#######.#######.#.#.#######.#####.#.
.#.#.#...#...#...#...#...#.......#.#.#.....#.....#...#.
.#.#.###.#.###.#.###.#.#.#######.#.#.#######.#####.###.
.#.#...#.#...#.#.....#.#.#...###...#.....#...#...#.#.#.
.#.#.###.###.#.#.#####.#.#.#.###########.#.###.#.#.#.#.
.#...#...#...#.#.......#...#...........#.#.....#...#.#.
.#.###.###.###.#######################.#.###########.#.
.#...#.#.......#####################...#.#...........#.
.###.###.###########################.###.#.###########.
...#...#.###########################.#.#...###.....###.
##.###.#.###########################.#.#.#####.###.###.
.....#...#########################...#.#.....#...#...#.
######.###########################.###.#####.###.###.#.
.....#...#########################.....#####.###...#...
.###.###.###################################.#####.####
.#...###.#################################...#.....#...
.###.###.#################################.###.#######.
...#.###.###########################.....#.#...#.......
.#.#.###.###########################.###.#.#.###.#####.
...#.....###########################...#...#.........#.