.#.......#...........#.........#.......................#############.....#.............................#######.......###
.#.#####.#.#########.#.#######.#.#####################.#############.###.#.###########################.#######.#####.###
...#####...###...#...#.......#...#####.........#.....#...###########...#...#.........................#.#######.#...#.###
##############.###.#####.###.#########.#######.#.###.###.#################.#.#######################.#.#######.#.#.#.###
.....#.........#...#.....###.........#.#######...###...#.###########.....#.#.#...............#...#...#...#...#...#.#...#
.###.#.#########.#####.#############.#.###############.#.###########.###.#.#.#.#############.#.#.#.#####.#.#.#####.###.#
.#...#.#.......#.....#...........#...#.###########...#.#.......#####...#...#.#...#.....#####.#.#...#...#...#.#.....#.#.#
.#.###.#.#######.###.###########.#.###.###########.#.#.#######.#########.###.###.#.###.#####.#.#####.#.#####.#.#####.#.#
...###.#.......#.#.#.#.......#...#.....###...#####.#.#.......#.......#...#...#...#.#...#...#.#.#.....#.#...#...#...#...#
.#####.#######.#.#.#.#.#.###.#.###########.#.#####.#.#######.#######.#.###.###.###.#.###.#.#.#.#.#####.#.#.#######.#.###
.......#.......#...#.#.#...#.#...#.........#.......#.###...#.#.#...#...#.......#...#...#.#.#.#.#.#.......#...#.....#...#
########.###########.#.###.#.###.#.#################.###.###.#.#.#.#.###.#######.#######.#.###.#.#.###########.#.#####.#
.....#.........#...#...#...#.....#.#.....###########...#.#...#...#.#.....#...#.#.....#...#.....#.#.........#...#.....#.#
.###.#####.###.#.#.#####.#########.#.###.#############.#.#.#######.#######.#.#.#.#####.#########.#.#######.#.#########.#
...#.......#...#.#.....#.#.........#.#...###########...#.#.....#...#.....#.#...#.....#...........#.#...###...#...#...#.#
.#.#########.###.#####.#.#.###########.#.###########.###.#####.#.###.###.#.#########.#############.#.#.#######.#.#.#.#.#
.#.#.......#...#.....#...#.#...........#.......#####...#...###.#.....#.#...#.......#.#.........#...#.#.......#.#...#...#
.#.###.###.#########.#####.#.#########.#######.#######.###.###.#######.#.###.#####.#.#####.###.#.#####.#####.#.#########
.#...#.#.#...#.....#.#.....#.#.......#.....#...#.......#...#...#...#...#.#.#...#.........#...#.#.......#...#.#.........#
.###.#.#.#.#.#.###.#.#.#####.#.#####.#######.#.#.#######.###.###.#.#.###.#.#####.#######.###.###.#######.#.#.#########.#
.#.#...#.#.#.#.#...#...#.....#.....#...#.....#.#.#.......#.#.#...#.....#.#.....#.....###...#...#.#.....#.#.....#.....#.#
.#.#####.#.#.#.#.#######.#########.###.#.#####.#.#.#######.#.#####.###.#.#.###.#####.#####.###.###.#####.#######.#####.#
.........#.#.#.#.#...#...#.......#...#...#...#.#.......#...#.......#...#...#.#.....#.....#.....#...#.....#.....#.....#.#
.#.#######.#.#.#.#.#.###.#.#####.###.#####.###.#######.###.#########.#######.#.###.#####.#######.###.#######.#.#####.#.#
.#.......#.#.#.#.#.#.....#.#.....###.....#.....#...#.#.....#.......#.#.....#.#.#...#.....#.......#.#.......#.#.....#...#
.#######.#.###.#.#.#.#####.#.###########.#######.#.#.#######.#######.#.#.#.#.###.###.#.###.#.#####.#.#####.#.#####.#####
.#.#...#.#.....#...#...#...#...#.....#...#.....#.#.........#.#...#...#.#.#.#.....#...#.....#.....#.#.....#...#...#.....#
.#.#.#.#.###########.###.###.###.#.###.###.###.###.#######.#.###.#.###.#.#.#.#######.###########.#.#####.#####.#.#####.#
.#.#.#...#.........#.....#.#...#.#...#...#.#.......#...#.#...#...#.....#.#.#.#.....#.#####...#...#...#.#.......#.#...#.#
.#.#.#####.#######.#######.#.#.###.#.###.#.#########.#.#.#.###.#########.#.#.#.###.#.#####.###.#####.#.#.#######.#.###.#
...#.........#...#.........#.#...#.#...#.#.........#.#.#.#.#.#.........#.#...#...#...#...#...#...#...#...#...#...#.....#
##.###########.#.###########.###.#.###.#.#########.#.#.#.#.#.#.#.#######.#.#####.#####.#.###.###.#.#######.#.#.#########
...#...#.......#.......#.....#.#...#.#.#.....#...#.#.#...#...#.#.....#...#.#...#.......#...#.#.#.#...#.....#.#.........#
.###.#.#.###############.#.###.#.###.#.#####.#.#.#.#.#######.#.#####.#.#####.#.#.#########.#.#.#.###.#.###############..
.....#...................#.....#.....#.....#...#...#...........#.....#.......#...........#.....#.....#..................