.#...........#.................#...#...............#...................#...#...........#...#...#.................#...........#########...###...#.................###.............#.....#...#.........................#.......#.................#.....#...#
.###.#######.#.###############.#.#.#.#############.#############.#####.#.#.#.#########.#.#.#.#.###.#############.#.#########.#########.#.###.#.#######.#########.###.###########.#.###.#.#.###.#####################.#.#####.#.###############.#.###.###.#
...#.....###...#.....###.....#.#.#...#...........#.....#.......#.#...#...#...#...#...#...#.#.#.....#.......#.....#.....#...#.###.....#.#.....#.......#.#########...#.#...#.....#.#.#...#.#...#.....#######.....#####...#...#...#...#.......#.#.#...#.....#
##.###.#.#######.###.###.###.#.#.#####.#########.#####.#.#####.###.#.###.#####.#.###.#.###.#.#######.#####.#.#########.#.#.#.###.###.#.#############.#.###########.#.#.#.#.###.#.#.#.#####.#.#####.#######.###.#########.#.#####.#.###.###.#.#.###.#.#####
...#...#.......#.#...###...#.#.#.#.....###...#...#...#.#.#...#.....#...#...#...#.....#.#...#.#.....#.....#.#...#.....#.#.#.#...#.#...#...#.........#.#.###.......#...#.#...###.#...#.....#.#.......#######.#.#...###...#.#.......#...#.###.#.#...#.#.....#
.###.#########.###.#.#####.#.#.#.#.#######.###.###.#.#.#.###.#########.#.#.#####.#####.#.###.#.###.#.#####.###.#.#.#.#.#.#.###.###.#.###.#.#######.#.#.###.#####.#########.###.#########.#.###############.#.#.#.###.#.#.###########.#.###.#.###.#.#####.#
...#.#####...#...#.#.....#.#.#...#.#.....#.#...#...#.#.#.....#.....#.....#.....#.#...#.#.....#.#...#.....#...#...#.#...#.#...#...#.#...#.#...#...#...#...#.#...#.........#.###.....#####...#.....#.......#.#.#.#...#.#...#.......#...#.#...#...#...#.....#
##.#.#####.#.###.#.#####.#.#.#####.#.###.#.#.#####.###.#.#####.#####.#########.#.#.#.#.#########.#.#####.###.#####.#####.###.###.#.###.#.#####.#.#.#####.#.###.#.#######.#.#######.#########.###.#.#####.#.#.###.#.#.#####.#####.#.###.#.#####.#####.#####
.#...#####.#...#.#.#...#...#.......#.#.#...#.....#...#.#.#...#.###...#.....#...#...#.#.....#.....#.....#.#...###...#.#.....#.###...#...#.#...#.#...#.....#.#...#.....#...#...#####...........#.#.#.....#.#.#.....#...#.....#...#.#.....#.....#...###.....#
.#.#######.###.#.#.#.#####.#########.#.#.#######.###.#.#.#.#.#.###.###.###.#.#######.#####.#.#########.#.#.#####.###.#.###.#.#######.#####.#.#.#.###.#####.#.#######.#.#####.#################.#.#.###.#.#.###########.#####.#.#.###########.###.#######.#
.#.........#.#.#...#.....#...#.......#.#.......#.....#.#...#.#.#...#...###.#...###...#.....#.#.......#...#.....#.#...#.###.#.###...#.###...#...#.....#.....#.....###.#.......###...........#...#...#.#.#...#.......#...#.....#.#...#.......#.....#.....#.#
.###########.#.#########.###.#.#.#####.#######.#######.#####.#.#.###.#####.###.###.###.#####.###.###.#########.###.#.#.###.#.###.#.#.###.#############.#########.###.###########.#########.#.#######.#.###.#.#####.###.#.#####.###.#.#####.#######.#####.#
.....#.......#...........#...#.#.#.....#####...#.....#.#.....#...#...###...#.#...#.#.#.#.......#.#...###...###...#.#...###.#.....#.#.....#.#...........###.....#.###.......#...#...#.#...#...#.......#...#.#...#.......#.....#...#...#...#.......#...#...#
.###.#.###################.###.#.###.#######.###.###.#.#.#########.#####.###.#.#.#.#.#.#####.#.#.#.#####.#.#####.#.#######.#######.#######.#.#.###########.###.#.#########.#.#.###.#.#.#.###.###.#######.#######.#########.#.###.#####.#.#######.###.#.###
.#.....###...#.#.......###.....#.....#######.....#...#.#.#.#...........#.....#.#.#.#.#.......#.#.#.....#.#...#.#...#.....#.#...#.#.......#...#.#.......###...#...#####...#...#.....#.#.#...#.....#.....#.....#...#.......#.#...#.......#.#.....#...#.#.#.#
.#########.#.#.#.###.#.###########################.###.#.#.#.#########.#######.#.#.#.#########.#.#####.###.#.#.#.#####.#.#.#.#.#.#.#####.#####.###.###.#####.#########.#.###########.#.###.#######.###.#####.#.###.#####.#.###.#########.#.###.###.#.#.#.#
...#.....#.#.#...#...#...#.......#######...#...#...#.#.#...#...#.....#.#.....#.#...#.#.......#...#.#...#...#...#.#...#.#.#...#.#.#.....#.#####...#.###.....#.#...#.....#...#.....#...#...#.....###.#...#...#.#...#.#...#...#.#...#.#...#...#...#.....#.#.#
.#.#.###.#.#.#####.#####.#.#####.#######.#.#.#.#.###.#.###.###.#.###.#.#.#####.#####.#.###.#.#####.#.###.#.#####.#.#.#.#.#####.#.#####.#.#######.#.#######.#.#.#.#.#######.#.#####.#####.#.###.###.#.###.#.#.###.#.#.#.#####.#.#.#.#.#.###.#####.#####.#.#
.#.....#...#.......#...#...#...#.......#.#...#.#.#...#.....#...#.#...#.#...#...#.....#...#.#.......#.#...#.....#.#.#...#...#...#...#...#.#...#...#...#...#.#...#...#.....#...#...#.....#.#.###.....#.....#.#.....#.#.#.......#.#.#...#.#...#...#...#...#.#
########.###########.###.#####.#.#####.###.###.###.#.#######.###.#.#####.#.#.###.#######.#.#########.#.#######.#.#.#######.#.#####.#.###.#.#.#.#####.#.###.###.#####.#####.###.#.#####.#.#.#######################.#.###########.#.###.#.###.#.#.###.###.#
...#.....#.........#...#.#.....#.....#...#.#.#.....#...#.#.......#...#...#.#.....#.......#.#...#...#...#.....#.#...#.#...#.#.#.....#...#.#.#...#.....#...#...#.#.....#...#...#.#.....#.#.#.#...#.........#.......#.#...#...#.....#...#.#...#.#.....#.....#
.#.#.#.###.#######.###.#.#.#########.###.#.#.#.#######.#.#.#########.#.###.#######.#######.#.#.#.#######.#####.#####.#.#.#.#.#.#######.#.#.#####.#######.#.#.#.#.###.#.#.#.#.#.#####.#.#.#.#.#.#.#########.#.###.#.###.#.#.#.#######.#####.#.#####.#######
.#.#.#.#.#...#...#.#...#...#.#.....#.#...#...#...#...#.#.....#.......#...#...#.....#.....#...#.#.....#...#.#...#...#.#.#...#.#...#...#.#...#.............#.#...#...#...#.#.#.#...#...#.#.#...#.#.#.........#.#...#.#...#.#.#...#...#.....#.#.....#...#...#
.#.#.#.#.#.#.###.#.#.#.#####.#.###.#.#.#####.#####.#.#.#######.#######.#.###.#.#####.#########.#.###.#.###.#.###.#.#.#.#####.###.#.###.#####.###.#########.#######.#####.#.#.###.#.###.#.#####.#.#.###########.###.#.###.#.###.#.#######.#.###.#####.#.###
.#...#.#...#.....#.#.#.......#.#...#.#.#...#...#...#.#.....#...#.......#.#...#...#...........#.#...#...#...#.....#...#.....#.#...#.#...#...#...#.........#.#.......#...#.#.#...#.#...#.#...#.......#.........#.#...#.....#.#.#...#.....#...#.#...#.#.#...#
##.#####.#.#######.#.#######.#.#.###.#.#.#.#.#.#.###.#####.#.###.#########.#####.#.#########.#.#####.###.#################.#.#.###.#.###.#.###.#########.#.###.#####.###.#.###.###.#.#.#####.#######.#######.#.#.#########.#.#.###.###.#####.#.#.#.#.#.#.#
...#.....#...#.....#.#.....#...#.#...#...#...#.#...#.....#...#.#...#.....#.....#.#.#.......#.#.....#.#.....#.....#...#...#.#...#...#.....#...#.#.........#...#.#.......#.#...#.....#.#.#.....#.......#.....#.#.#...#.....#...#...#.#...#.#.....#...#...#.#
.###.#######.#.#####.###.#.#####.#.###########.###.#####.#####.#.###.###.#####.#.#.#.###.###.#####.#.#####.#.###.#.#.#.#.#.#####.###########.#.#.###########.#.#######.#.###########.#.#.#####.#####.#.#####.#.###.#.###.#.###.#.#.#.###.#.#############.#
.#...#.....#.#.....#...#.#...#...#.#.......#.#...#.....#...#...#.#...#.#.....#...#.#...#.....#...#.#.......#...#...#.#.#...#.....#.....#...#...#.#.........#.#...#.....#.......#...#...#.#.....#...#.#...#...#.....#...#...#...#.#.#.....#.#.#.....#...#.#
.###.#.###.#.#####.###.#.###.#.###.#.#####.#.#.#####.#.###.#.###.#.###.#.###.#####.###.#########.#.#.#########.#####.#.#######.###.###.#.#.#####.#.#######.#.###.#.###########.#.###.###.#.#####.#.###.#.#.#############.###.###.#.#######.#.#.###.#.#.###
...#.....#.#.....#...#.#...#.#.#.#...#...#...#.#...#.#...#.......#...#.#.#.#.........#.........#.#.#.#.........#...#.#.........#...#.#...#.....#.#.#.#.....#.........#.....#...#.#...#...#.....#.#...#.#.#...#.......#.....#...#.#.....#.#...#...#...#...#
.#.#######.#####.###.#.#.#.#.#.#.#.###.#####.###.#.#.###############.#.#.#.#.#################.#.#.#.###.#######.#.#.###########.###.#.#######.#.#.#.#.###############.###.#.###.#.###.#######.#.###.#.#.#.###.#####.#.#######.#######.#.###.#######.###.#
.#.........#...#...#...#.#.#.#...#.........#.....#...#...............#.#...#...#...#.......#...#.#...#...#.......#.#.#.....#.....#...#.....#...#.#...#...#.#...#.......#.#...#...#...#.#.....#.#.#...#.#.#...#.#...#.#.......#.......#.#...#.....#...#.#.#
.###########.#####.#.###.#.#.#############.###########.###############.#######.#.#.#.#####.#.###.#####.###.#######.#.#.#####.#####.#######.#.###.###.###.#.#.#.#.#.#####.#####.#.###.#.#.###.#.#.#.###.#.###.#.#.###.#.#####.#######.#.###.#.###.#.###.#..
...................#.....#.#.............#...................................#...#...#.....#...............#.......#.........#.............#...#...#...#.....#...#.............#...#.....#.......#.....#...#...#.....#.....#...............#...#...#......