#############################
#                           #
#                           #
#                           #
#                           #
#          F                #
#                           #
#                           #
#                           #
#                           #
#                           #
#                           #
#                           #
#                           #
#             S             #
#                           #
#                           #
#                           #
#                           #
#                           #
#                           #
#                           #
#                           #
#                           #
#                           #
#                           #
#                           #
#                           #
#                           #
#                           #
#############################
                             
                             
                             
                             
                             
                             
                             
                             
                             
                             
                             
                             
                             
