XXXXXXXXXXXXXXXXXXXOXXXXXXXXXXXXXXXXXXXX
XXXXXXXXXXXXXXXXXXX XXXXXXXXXXXXXXXXXXXX
XXXXXXXXXXXXXXXXXXX XXXXXXXXXXXXXXXXXXXX
XXXXXXXXXXXXXXXXXXX XXXXXXXXXXXXXXXXXXXX
XXXXXXXXXXXXXXXXXXX XXXXXXXXXXXXXXXXXXXX
XXXXXXXXXXXXXXXXXXX XXXXXXXXXXXXXXXXXXXX
XXXXXXXXXXXXXXXXXXX XXXXXXXXXXXXXXXXXXXX
XXXXXXXXXXXXXXXXXXX XXXXXXXXXXXXXXXXXXXX
XXXXXXXXXXXXXXXXXXX XXXXXXXXXXXXXXXXXXXX
XXXXXXXXXXXXXXXXXXX XXXXXXXXXXXXXXXXXXXX
XXXXXXXXXXXXXXXXXXX XXXXXXXXXXXXXXXXXXXX
XXXXXXXXXXXXXXXXXXX XXXXXXXXXXXXXXXXXXXX
XXXXXXXXXXXXXXXXXXX XXXXXXXXXXXXXXXXXXXX
XXXXXXXXXXXXXXXXXX   XXXXXXXXXXXXXXXXXXX
XXXXXXXXXXXXXXX       XXXXXXXXXXXXXXXXXX
XXXXXXXXXXXXXXXXX     XXXXXXXXXXXXXXXXXX
XXXXXXXXXXXXXXXXXX XXXXXXXXXXXXXXXXXXXXX
XXXXXXXXXXXXXXXXXX XXXXXXXXXXXXXXXXXXXXX
XXXXXXXXXXXXXXXXXX XXXXXXXXXXXXXXXXXXXXX
XXXXXXXXXXXXXXXXXX  XXXXXXXXXXXXXXXXXXXX
XXXXXXXXXXXXXX          XXXXXXXXXXXXXXXX
XXXXXXXXXXXXXX          XXXXXXXXXXXXXXXX
XXXXXXXXXXXXXX          XXXXXXXXXXXXXXXX
O          XXX           XXXX        XXX
XXXXXXXXXX         G          XXXXXX   O
XXXXXXXXXXXXXX           XXXXXXXXXXXXXXX
XXXXXXXXXXXXXX           XXXXXXXXXXXXXXX
XXXXXXXXXXXXXX           XXXXXXXXXXXXXXX
XXXXXXXXXXXXXX           XXXXXXXXXXXXXXX
XXXXXXXXXXXXXXXXXX XXXXXXXXXXXXXXXXXXXXX
XXXXXXXXXXXXXXXXXX XXXXXXXXXXXXXXXXXXXXX
XXXXXXXXXXXXXXXXXX XXXXXXXXXXXXXXXXXXXXX
XXXXXXXXXXXXXXXXXX XXXXXXXXXXXXXXXXXXXXX
XXXXXXXXXXXXXXXXXX  XXXXXXXXXXXXXXXXXXXX
XXXXXXXXXXXXXXXXXXX XXXXXXXXXXXXXXXXXXXX
XXXXXXXXXXXXXXXXXXX XXXXXXXXXXXXXXXXXXXX
XXXXXXXXXXXXXXXXXXX XXXXXXXXXXXXXXXXXXXX
XXXXXXXXXXXXXXXXXXX XXXXXXXXXXXXXXXXXXXX
XXXXXXXXXXXXXXXXXXX XXXXXXXXXXXXXXXXXXXX
XXXXXXXXXXXXXXXXXXXOXXXXXXXXXXXXXXXXXXXX
