...............#######.........###...#.....#...#.#
##############.#######.#######.###.#.#.###.#.#.#.#
.............#.....#...#.....#...#.#...#.....#...#
.###.#######.#####.#.#####.#.###.#.###############
...#.......#.....#.#.#...#.#...#.#.........#.....#
##.#######.#####.#.#.#.#.#.###.#.#########.#.###.#
##.#######...#...#.#.#.#.#.#.#.#...........#.#...#
##.#########.#.###.#.#.#.#.#.#.#############.#.#.#
...#######...#.#...#.#.#...#.#...............#.#.#
.#########.###.#.###.#####.#.#################.#.#
.#.....###.#...#.....#.....#...#...#####.....#.#.#
.###.#.###.#.#########.#######.#.#.#####.###.#.#.#
...#.#...#.#...........#.......#.#.###...#.#...#.#
##.#.###.#.###############.#####.#.###.###.#.#####
...#.#...#...........#...#.....#.#.#...#...#.....#
.###.#.#############.#.#.###.#.#.#.#.#####.#####.#
.#...#...#.........#...#.....#...#.#.......#####.#
.#.#####.#.#########.#############.#############.#
.#...###.#...#...#...#.........#...#.......#...#.#
.###.###.###.#.#.#.###########.#.###.#.###.#.#.#.#
...#.###...#.#.#.#.......#...#.#.....#.#...#.#...#
##.#.#####.#.#.#####.###.#.#.#.#######.#.###.#####
...#.#####...#.....#...#...#.#.#.......#...#...#.#
.###.#############.###.#####.#.###########.#.#.#.#
.#.......###.......#.#.....#.#.............#.#...#
.#.#####.###.#######.#.#####.#.###################
...#.....#...#.......#...#...#...#...#...#...#...#
.###.#####.###.#########.#.#####.#.###.#.#.#.###.#
...#...#...#.....#######.#...###...#...#.#.#.....#
.#.#.#.#.#######.#######.###.#######.###.#.#######
.#.#.#.#.#.......#######.#...#...###.#.#...#.....#
.#.#.#.#.#.#############.#.###.#.###.#.#.###.###.#
.#...#.#...#...#.......#.#.....#.....#.#.#...###.#
.#######.###.#.###.###.#.#############.#.#.#####.#
.#.......#...#...#.#...#.........#.....#.#.#.....#
.###.#####.#####.#.#.###########.#.#####.#.#.#####
.....#.....#...#...#...#.....#.#.#.....#.#.#.....#
########.###.#.#######.#.###.#.#.###.###.#.#####.#
.....#...#...#...#...#.....#...#...#.....#.....#.#
.#.###.#.#.#####.#.#######.#######.###########.#.#
.#...#.#...#.#...#.....#.#.......#.#.........#.#.#
.###.#.#####.#.#.#####.#.#.#######.#.#######.#.#.#
...#...#...#.#.#.#...#...#.....#...#...#...#...#.#
.#.#######.#.#.###.#.###.###.###.#####.###.#.###.#
.#.......#.#...#...#...#...#...#.......#...#...#.#
.#######.#.#####.#####.###.#.#.#########.#####.#.#
.#.....#...#.....#...#...#.#.#.......#...#...#.#.#
.#.#####.###.#####.#.###.#.#####.###.#.###.#.###.#
.........###.......#...#.........#...#.....#......
################################################..