.......#.....#.......#.......#...#################
######.###.#.#.#####.###.###.#.#.#################
...###.....#.#.#####...#...#.#.#...###############
.#.#########.#.#######.###.#.#.###.###############
.#...#.....#.#.#######.....#.#.###.......#########
.###.#.###.#.#.#############.#.#########.#########
...#...#...#.#.#############...#########.#########
####.###.###.#.#########################.#########
.....###...#...#########################...#######
.#########.###############################.#######
.#########.#####...#######################...#####
.#########.#####.#.#########################.#####
.#########...#...#.#########################.#####
.###########.#.###.#########################.#####
...#########.#...#.........#####...#######...#####
##.#########.###.#########.#####.#.#######.#######
##.....#####...#...#.....#.#...#.#...#####.###...#
######.#######.#####.#.#.#.#.#.###.#.#####.###.#.#
####...#######...#...#.#.#...#...#.#...###...#.#.#
####.###########.#.#####.#####.#.###.#.#####.#.#.#
##...#####...###.#.....#.#.....#...#.#...#.#...#.#
##.#######.#.###.#####.#.#.#######.#.###.#.#.###.#
...#...#...#.....#...#.#...#...#.#...###...#...#.#
.###.#.#.#########.#.###.###.#.#.#.###########.###
...#.#.#.#.........#...#...#.#...#.........#.#...#
.#.#.#.#.#.###########.###.#.#############.#.#.#.#
...#.#.#.#...#.......#...#...#####.....#...#.#.#.#
####.#.#####.#.#####.###.#.#######.###.#.###.#.#.#
...#.#.....#.#.....#...#.#.#.....#.#.#.#...#.#.#.#
.#.###.###.###.###.###.#.#.#.###.#.#.#.###.#.#.#.#
.#.#...#.#...#.#...#...#.#...#.#.....#.#.#...#.#.#
.#.#.###.###.#.#.###.###.#####.#####.#.#.#.#####.#
.#...#...#.#.#.#.#...#.....#.......#.#.#.#...#...#
.#####.#.#.#.#.#.#.#######.#.#####.#.#.#.###.#.###
...#...#.#.#...#.#.........#.#...#...#.#...#.#.#.#
##.#.#.#.#.#####.#############.#.###.###.#.#.#.#.#
.....#.#...#.....#.......###...#...#...#.#.#.#...#
.#####.#####.#####.#####.###.#####.###.#.###.###.#
...###...#...#.....#.....#...#...#...#.#.....#...#
##.#####.#.#######.#.#####.###.#.###.#.#######.###
...###...#.#.......#.....#.#...#.#.#...#.#.....#.#
.#####.###.#.###########.#.#.###.#.#.###.#.#####.#
.....#...#...#.......#...#...#...#.#.#...#.......#
.#.#.###.#####.#######.###.###.###.###.#.#########
.#.#.#.#...#.........#.....#.#...#.....#.#.......#
.#.#.#.#.#.#########.#######.###.#.#####.###.###.#
.#.#.#.#.#...........#.....#...#...#...#.....#.#.#
.#.#.#.#.#############.#####.#.#####.###.#####.#.#
...#...#.............#.......#...........#........
################################################..