.....#.......#.......#...
####.#.#####.###.###.#.#.
...#...#####...#...#...#.
.#.###########.###.#####.
.#...###...#...###.#...#.
.###.###.#.#.#####.#.###.
...#.....#.#.......#.#...
.#.#######.#########.#.##
.#.....#.#.....#.....#.#.
.#####.#.###.###.#.###.#.
.#.#...#...#...#.#.#...#.
.#.#.###.#.###.#.#.#.###.
.#.#.....#...#...#.#...#.
.#.#.#######.#####.###.#.
.#.#.....#.#.....#...#...
.#.#####.#.#####.#######.
.#.#.....#.....#.......#.
.#.#######.###.#.#####.#.
.#.........#...#.....#.#.
.###########.#########.#.
.#.........#...#.#.....#.
.#.###.###.###.#.#.#.###.
.#...#.#...#.#.....#.#...
.###.#.#.###.#########.#.
.....#.#.................